+---+---+---+---+
|           |   |
+   +---+   +   +
|   |   |   |   |
+   +---+   +   +
|           |   |
+---+---+---+   +
|               |
+---+---+---+---+