+---+---+---+---+
|   |   |   |   |
+   +   +   +   +
|   |   |   |   |
+   +   +   +   +
|   |   |   |   |
+   +   +   +   +
|   |   |   |   |
+---+---+---+---+