+---+---+---+---+---+---+---+---+
|   |   |   |   |   |   |   |   |
+   +   +   +   +   +   +   +   +
|   |   |   |   |   |   |   |   |
+   +   +   +   +   +   +   +   +
|   |   |   |   |   |   |   |   |
+   +   +   +   +   +   +   +   +
|   |   |   |   |   |   |   |   |
+---+---+---+---+---+---+---+---+