+---+---+---+---+---+---+---+---+
|                           |   |
+   +---+---+---+---+---+   +---+
|   |                   |       |
+   +   +---+---+---+   +---+   +
|   |   |           |       |   |
+   +   +   +---+   +---+   +   +
|   |   |   |   |       |   |   |
+   +   +   +---+---+   +   +   +
|   |   |       |   |   |   |   |
+   +   +---+   +---+   +   +   +
|   |       |           |   |   |
+   +---+   +---+---+---+   +   +
|       |                   |   |
+---+   +---+---+---+---+---+   +
|   |                           |
+---+---+---+---+---+---+---+---+